11111111111111
10C01000000001
10P01011111101
1000101E000101
1C000011C10001
11111111111111

1111111111111111111111111111111111111111
101001C00P0C1111111111111111111111111111
1111110111111111111111111111111111111111
1C000000000C11111111111111111111          11111111
1111E11000001111111111111111111111111111            
1111111111111111111111111111111111111111