11111111111111
10C01000000001
10P01011111101
11E11000000101
1C000000C10001
11111111111111