1111111111111111111111111111111111111111                               
101001C00P0C1111111111111111111111111111
1111110111111111111111111111111111111111                                                
1C000000000C1111111111111111111111111111            
1111E11000001111111111111111111111111111                                                                                                
1111111111111111111111111111111111111111




