1111111111111111111111111111111111111111                               
101001C00P0C1111111111111111111111111111
111111000000000000000000000000C000001111                                                
1C000000000000000000000000C0000000011111            
1111E11000000C0000000000000000C000011111                                                                                                
1111111111111111111111111111111111111111




